F 76,76,76
C 99,99,99

NO              textures/n.xpm                  
SO              textures/redbrick.xpm
WE              textures/w.xpm
EA              textures/eagle.xpm

1111111111111111111
1011111111111111111
1001111111111111111
1000111111111111111
1000111111111111111
10N0001001001000001
1011000001000001001
1001001001111101111
1001111000001001001
1000000000000001001
1001111111111001001
1111000000000001011
1000000001000000001
1111111111111111111

