NO textures/n.xpm
SO textures/s.xpm
WE textures/w.xpm
EA textures/e.xpm
F 0,0,0
C 255,255,255
111111111111111
100000000110001
111110000000001
100000000000001
10N000000000001
100000000000001
111111111111111